22,22,22,22,22,22,49,22,18,3,22,22
22,22,22,22,49,22,48,22,22,22,22,22
22,22,1,2,3,22,22,22,22,22,22,22
22,22,60,8,10,2,3,22,22,22,22,22
2,2,11,8,18,8,61,22,22,22,22,22
8,8,18,8,8,8,61,22,22,22,22,22
8,8,4,14,14,14,15,22,22,22,22,22
14,14,15,22,22,50,22,22,22,22,22,22
22,22,22,22,52,58,58,58,58,58,58,58
22,22,22,22,53,68,42,68,68,42,68,68
22,22,22,22,53,68,68,68,68,68,68,68
