22,22,22,22,22,22,22,22,18,3
22,22,22,22,22,22,22,22,22,22
22,22,1,2,3,22,22,22,22,22
22,22,7,8,10,2,3,22,22,22
2,2,11,8,18,8,9,22,22,22
8,8,18,8,8,8,9,22,0,18
8,8,4,14,14,14,15,22,20,9
14,14,15,22,22,22,22,22,12,15
22,22,22,22,22,0,19,20,21,4
19,20,20,21,22,6,22,22,4,15
